+ - - - - - - - - - - - - - - - - - - - - - - - - - - - - - - - - - - - - - - - - - - - - - - - - - - - - - - - - - - +
| * * * * * * * * * * * * * * * * * * * * * * * * * * * * * * * * * * * * * * * * * * * * * * * * * * * * * * * * * * |
| * * * * * * * * * * * * * * * * * * * * * * * * * * * * * * * * * * * * * * * * * * * * * * * * * * * * * * * * * * |
| * * * * * + - - - - - - + * * * * * * * * * * * * * * * * * * * * * * * * * * * * * * * * * * * * * * * * * * * * * |
| * * * * * | * * * * * * | * * * * * * * * * + - - + * * * * * * * * * * * * * * * * * * * * * * * * * * * * * * * * |
| * * * * * | * * * * * * | * * * * * * * * * | * * | * * * * * * * * * * * * * * * * * * * * * * * * * * * * * * * * |
| * * * * * | * * * * * * | * * * * * * * * * | * * | * * * * * * + - - - + * * * * * * * * * * * * * * * * * * * * * |
| * * * * * + - - + * * * | * * * * * * * * * + - - + * * * * * / * * * * | * * * * * * * * * * * * * * * * * * * * * |
| * * * * * * * * | * * * | * * * * * * * * * * * * * * * * * / * * * * * * \ * * * * * * * * * * * * * * * * * * * * |
| * * * * * * * * * * * * | * * * * * * * * * * * * * * * * / * * * * * * * | * * * * * * * * * * * * * * * * * * * * |
| * * * * * * * * * * * * | * * * * * * * * * * * * * * * / * * * * * * * * | * * * * * * * * * * * * * * * * * * * * |
| * * * * * * * * + - - - + * * * * * * * * * * * * * * + - * * - - - - - - + * * * * * * * * * * * * * * * * * * * * |
| * * * * * * * * * * * * * * * * * * * * * * * * * * * * * * * * * * * * * * * * * * * * * * * * * * * * * * * * * * |
| * * * * * * * * * * * * * * * * * * * * * * * * * * * * * * * * * * * * * * * * * * * * * * * * * * * * * * * * * * |
| * * * * * * * * * * * * * * * * * * * * * * * * * * * * * * * * * * * * * * * * * * * * * * * * * * * * * * * * * * |
| * * * * * * * * * * * * * * * * * * * * * * * * * * * * * * * * * * * * * * * * * * * * * * * * * * * * * * * * * * |
| * * * * * * * * * * * * * * * * * * * * * * * * * * * * * * * * * * * * * * * * * * * * * * * * * * * * * * * * * * |
| * * * * * * * * * * * * * * * * * * * * * * * * * * * * * * * * * * * * * * * * * * * * * * * * * * * * * * * * * * |
| * * * * * * * * * * * * * * * * * * * * * * * * * * * * * * * * * * * * * * * * * * * * * * * * * * * * * * * * * * |
+ - - - - - - - - - - - - - - - - - - - - - - - - - - - - - - - - - - - - - - - - - - - - - - - - - - - - - - - - - - +